F 192,137,90

NO ./src/images/brik.xpm

SO ./src/images/brik.xpm

C 135,206,255

EA ./src/images/white.xpm

WE ./src/images/blue.xpm

11111111111111111111111
10000000010000000000001
100000E0010011110000001
10000000100010001000001
10000011000010001000001
10000000000011111000001
10000000000000000000001
11111111111111111111111